44
..................................................
..................................................
..................................................
..................................................
..................................................
..................................................
...........O..OO..................................
.........OOO.O.O.O................................
.........O..OOO..OO...............................
........O..OOOOOO.O.OOO...........................
.........O..OOO.O.OOOOO...........................
..............O.O.O.O.............................
........O.O...O.O.OOOOO...........................
........O..O.O..O.OO...O..........................
...........O..OO.......OOO........................
.........O...OOOOO.OOO..OO........................
............O.........O...........................
..........O.O.........O...........................
............OO.OOOOO...O..........................
..............O.OOO..O.....OO.....................
..............O..O...O.OOO.OO.....................
................OO...OOO.O..O...O.................
................OO....OO.OOOO...OOO...............
...........................O.O..O.................
.....................O.O.....OO..OO...............
.....................O..O.....O.OOO.....O.........
.....................O...O....OO..O...O..O........
.......................OOO.....OO........O........
.......................O.O..O..O.....OO..O........
.........................O..OO.OO.O..O............
........................O.......O.O...............
.........................O...OOOO.................
..........................O...O...................
..................................................
...............................O..................
..............................O.O.................
.............................OO...................
.............................O.O..................
.............................OO...................
...............................O..................
..............................O...................
..................................................
..................................................
..................................................
..................................................
