0000000000000011111000000000000000000000000000011000000000000000000000000000000000000011000010000000
0000010100000010001000011100000000000000000000011000000000000100000000000000000000000010000010000000
0000011010000000110000000100000000000000000000000000000000011100010100010000000000000011010100000000
0000110010000001000000011100000000000000000000000000000000100000001000110000000000000000100000000000
0000001111011010100000000000000000000000000000000000000000010100000001010100000010000000000000000000
0001100000100110000000000000000000000000000011000000000000001000000001000011000101100000000011011000
0001100000011110000000000000000000000011000100100000000000000000000000100101001100000110000100111100
0000000000010000000000000000000000010010000001000000000000000000000000001101000100000010101001011100
0000000000110000111000000000000000111010000100100000000000011000000000000110000000001101010000001100
0000000001101000101000000000000001100010000001101000000001011000000000000000000011011001000000110000
0110000010001000111000000000000001000001000001101100000010000100000000000000000011100000100000010000
0110000010110000000000000000000000010001000000000000000001011000000000000000000101000000010001100000
0000000001100000000000000000000011010101100000001100000000011000000000000000001101100000001000100000
0000000000000000000000000000000010001001000000000000000000000000000000000100010010110100000000000000
0000000001011000000000000000000000000010000000000000000000000000000000000010011010011000001000000000
0000000011100000010000000000001100110001100000000000000000001000000000001000110111111000000000001000
0000000000000000010100000000001001110000000000000000011000001000001000001000010110010000000000011100
0001000001000000011100000000001000100000000000000000101000001000001100001000100001000000001101010010
0010100000101000000000000000000100100111000000000000000000000000100010000001000010000000000010101010
0110110000111000000000000000011101100011000000000100000000000001000000000000010010110000000000001100
0010100000000000000000000011011000011000000000000000000000001000010000010000010000010000000000000000
0100011100000000000000001010001100001100001000000100000000111000000000101000010000100000000010000000
1011001100000000000000010001111000000000101010000010100000000000001001000000001000000000000010000000
1100000000000000000000001101010000000000111010000001100110001100000001011000001100000000000101000000
1000100110000000000010000000100000000011001101000000011100000101100000011000000000000000000101000000
1000100111000000000111000000000000001000000101100000000011101000100001010011000100000000010000010000
0100100111000000011001000000000000001001001101100000001000111000001000100001001000000000101010101000
0010000000001100011111000000000000001000100110000000001001100000001100000001110000000001110000000000
0000000000001100000010000000000000000000100000000000000001000000100010000000000000000000110000000000
0000000000001010001110000000000000000001000000000000010001100010000010000000000100000000011110000000
0000000000001010001000000000000000000000000000000000000011111110000001000111111010000000000000000000
0000000000001010000000111000010000000000000111000000000010111000000001000100110010000000001001000000
0000000000000000000000000100101000000000000001000000000010110100100010000111001000000000001000000000
0001101100000000000001010111101000000000000001101000100001100001010111100000000010000000000101000000
0000101100000000000001000111101000000000000001101000010111101111110000010000000101100000000010101000
0000001100000000000000110101101110000000000000001000001110000110011100010000110011100000000000110000
0000000000000001000000110000111110000000000001110000000000000010000000000000001010100111001000100000
0111000000000110110000000000011000000000000000110000000000000001100100000000100110000000000100011000
0101000000000110000000000000010000000000001100000000000000000000000000000000110111100111000000001000
0100100000100110001000000000100000000000100100000000000000000100000000001011010101110000000000000000
0011100000100000110011000000000000000001001111000000000000011100000000001010011000010000000111000000
0000001000011000100000000001000100000001000011000000000000100100000000000100000000000000000111000000
0000000100000010000110100001000110000001110111000000000001000100000000000000000000000000010001000000
0000000000110101101101000001000101100000000100000000000001000100000000000000000000000000010100000000
0000000000010000011100000000000010010000000000000000000011010000000000000000000000000000000000000000
0000100001000000010011000000000010010000000001000000000010010000000000000000010000000000000000000000
0000100010000110001000000011100010010000000011100001000110000000000000100000111000000000000000000000
0011111001011000000010000011000110000011000000000001000011000000000001010000101000000000000000000000
0110111000100000000000000011011000000111000011000000000001000000000010000001110000000000000000000000
0011001000000000000000000000100000011011000010000000000000000000000110101011110000000000000000000000
0001110000000000000111000000101000011010000011011000000000000000000110110000000000000100000000000000
0000000000000000000000000000000000001001100000000000000000000000000100100001111100011011000000000000
0000000000000000000101000000000000011000110000000000000000000000000100110000100100011000000010000000
0000000000000000000010001000000000011100110000000000000111100000000010010000010010001101001010000000
0000000000000000000000110100000000011100000000000000001111100000000100011100000000000010000000011000
0000000000000000000001000000000000000000000000000000000000111000010000011100110000000000001110100000
0110000000000000000001111000000000000000000000000000011010000000010110110111010111110000000110111000
0101011000000000000000010000000000000000110110110000000111000000001110100000010110000001100111000000
0101110001110000000000000000011000000000110000001000000000000000000010000110110110110011100110000000
0000010001000000000000000000011000000000001010010000011000000100001100000100011000011110100110000000
1010100110000000110000000000011000000000000000010000011000000100000010000000011011111000000000000000
1110000110000001100000110000000000000011000110000000000000000100000010000000011000001000000000000000
1100111000000001000000110000000100000111000000001000000000000000100100000000010000101000000000000000
0100010000000000000000000000001010001100000110001000000000000001101000000000010000001100000001000000
1010000000000000000000000000000111000101000110100100000000000000110000000000001000110000000000000000
0110000000100000000001110101000111001100001100111000000000000000000000000000000010110000110000001110
0000000001000000000000001010000011001000001100111000000000000000000000000000101000000001001000011101
0000000011010100000000001000000110010000100000100011000000000000000000000000000000000011011000011011
0000011001111100000001110000000000100110100011000011000000000011100000000101000000000000011000000000
0000011000101100000000000000000001110000110000000000000100000100100000001011110110000100100001000000
0000000000000000000000000000000000000000001000000000001010000100010000001010010110001000100010100000
0000000000000000000000000000000000001000011000000000010000000110010000000000001100000000000010100000
0000000000000000000000000000000000001000001000100000001011000001100000000000010000000000110011100000
0011000000000000000000000000000011100100001010110000000111000000000000000000011000110010110000000000
0100100000000000000000000000000000011101000101100000000000000000000000000000011111000110010011100000
0110110000000000000001100000000000101001100000000011100001100000000000000000000100000001001000100000
0010000000000000001001100000000001010001000000000101000011111000000000000000000000110001000000101000
1110000000010000010100000000000000010000100001101110000000111000000000000001101000000000001000100100
0101000001100000000010000000000000010100010110010110000110001000000000000001001000000000000100000100
0000100000000000000100000010000000010000000011110000000000001100000000000001000000000010001110000100
0000000000000001010000000101000000000100011000000000000000001000000000000000000000000000001010111000
00110100000
